F 30,240,100


NO    srcs/imgs/wall_text/a.xpm
SO	srcs/imgs/wall_text/b.xpm

EA srcs/imgs/wall_text/a.xpm

WE   			 srcs/imgs/wall_text/d.xpm
C 0,0,0

           111111111111111111111
          11000010000000000001
1111        1111111111111111111
11111
11011
10E01
11111