NO ./textures/NO.xpm
SO ./textures/SO.xpm
WE ./textures/WE.xpm
EA ./textures/EA.xpm

F 127, 127, 0
C 135,  						206,							 100


1111111111111111111111111111
1E00000100100110000000000001
1111111111111111111 11111111